10000001000000000000000000000001000000000000000000
11111101011111111111111111111101111111111111100000
00000101010000000000000000000101000000000000111100
11110101000000000000000000000101000000000000000000
00010101111111111111111111111101111111111111111110
01010100000000000000000000000001000000000100000000
01110111111111111111111111111111111111110101111110
00000000000000000000000000000000000000010101000010
11111111111111111111111111111111111111111111111110
00000000000000000000000000000000000000010000000000
01111111111111111111101111111111111111110111111110
01000111111111111110101010000000000000000100000010
01111100000000000000101011111111111111111101111110
01000000001111111111111001111111111111111111111110
01111111101000000000000000000000000000000000000000
00000000101111111111111111111111111111111111111110
11111111101000000000000000000000000000000000000010
10000000001111111111111111111111111111111111111010
10111110001000000000000000000000000000000000001010
10101001001111111111111111111111111111111110001010
10101001001010000100000000000000000000000000001010
10101001001011111100111111111111111111111111001010
10101001001000000000000000000000000000000001001010
11101001001111111111111111111111110100100101001010
00001001000000000000000000000000010100100101001010
00001001111111111111111111111111010100100101001010
00001001000000000000000000000001010100100101001010
00001001011111111111111111111111010100100101001010
00001001000000000000000000000001010100100101001010
00001111000000000000000000000001010100100101001010
00000000011111111111111111111111010100100101001010
00000000010000000000000000000000010100100101001010
11111111110000011111111111111111111111111111001110
00000000000000010000000000000000000000100000000000
11111111111111111111100011111100000000111111111001
01000000000000000000111110000100000000100000001001
01001111111000000000100000000111111111100000001001
01001000001000000000100000000000000000000000001001
01001000001000000000111111111111111111111111001001
01001000001000000000000000000000000000000001001001
01111000001000000000000000000001111111111111001001
00000000001111111111111111111111000000000001001001
11111111111001000000000000000000001111111111001001
00000000000001000000000000000000001000000000001001
11111111111111111111111111111111111000000000001001
00000000000000000000000000000000001000000000001001
01111111111111111111111111111111111000000000001001
01000000000000000000000000000000001111111111111111
01000000000000000000000000000000001000000000000000
01111111111111111111111111111111111111111111111111